38 38 38 38 38 38 38 38 38 38 38 38 38 38 38 38 38 38 38 38 38 38 38 38 38 38 38 38 38 38 38 38 38 38 38 38 38 38 38 38 38 38 38 38 38 38 38 38 38 38 38 38 38 38 38 38 38 38 38 38 38 38 38 38 38 38 38 38 38 38 38 38 38 38 38 38 38 38 38 38 38 38 38 38 38 38 38 38 38 38 38 38 38 38 38 38 38 38 38 38
38 38 38 38 38 38 38 38 38 38 38 38 38 38 38 38 38 38 38 38 38 38 38 38 38 38 38 38 38 38 38 38 38 38 38 38 38 38 38 38 38 38 38 38 38 38 38 38 38 38 38 38 38 38 38 38 38 38 38 38 38 38 38 38 38 38 38 38 38 38 38 38 38 38 38 38 38 38 38 38 38 38 38 38 38 38 38 38 38 38 38 38 38 38 38 38 38 38 38 38
38 38 38 38 38 38 38 38 38 38 38 38 38 38 38 38 38 38 38 38 38 38 38 38 38 38 38 38 38 38 38 38 38 38 38 38 38 38 38 38 38 38 38 38 38 37 38 38 38 38 38 38 38 38 38 38 38 38 38 38 38 38 38 38 38 38 38 38 38 38 38 38 38 38 38 38 38 38 38 38 38 38 38 38 38 38 38 38 38 38 38 38 38 38 38 38 38 38 38 38
37 37 45 45 45 45 45 45 45 45 45 45 45 45 45 45 45 45 45 45 45 45 45 45 45 45 45 45 45 45 45 45 45 45 45 45 37 37 37 37 37 37 37 37 37 37 37 37 37 37 37 37 37 37 37 37 37 37 45 45 45 45 45 45 45 45 45 45 45 45 45 45 45 45 45 45 45 45 45 45 45 45 45 45 45 45 45 45 45 45 45 45 45 45 45 45 37 37 37 37 37
37 43 0 0 0 0 0 0 0 0 0 0 0 0 0 0 0 0 0 0 0 0 0 0 0 0 0 0 0 0 0 0 0 0 0 0 42 37 37 37 37 37 37 37 37 37 37 37 37 37 37 37 37 37 37 37 37 43 0 0 0 0 0 0 0 0 0 0 0 0 0 0 0 0 0 0 0 0 0 0 0 0 0 0 0 0 0 0 0 0 0 0 0 0 0 0 42 37 37 37
37 43 0 0 0 0 4 4 4 4 4 4 4 4 4 4 4 4 4 4 4 4 4 4 4 4 4 4 4 4 4 4 4 4 4 0 42 45 45 45 45 45 45 45 45 45 45 45 45 45 45 45 45 45 45 45 45 43 0 0 0 0 0 0 0 0 0 4 4 4 4 4 4 4 4 4 4 4 4 4 4 4 4 4 4 4 4 4 4 4 4 4 4 4 4 42 37 37 37 37
37 37 41 0 0 4 4 4 6 7 8 9 4 4 4 4 4 4 4 4 4 4 4 4 4 4 4 4 4 4 4 4 4 4 4 0 0 0 0 0 0 0 0 0 0 0 0 0 0 0 0 0 0 0 0 0 0 0 0 0 0 0 0 0 0 0 0 0 0 0 0 0 0 0 0 0 0 0 0 0 0 0 0 0 0 0 0 0 0 0 4 4 4 4 4 42 37 37 37 37
37 37 43 0 0 4 4 4 10 11 12 13 4 4 4 4 4 4 4 4 0 39 40 40 40 41 0 4 4 4 4 4 4 4 4 4 4 4 39 40 40 40 40 40 41 4 4 4 4 4 4 4 4 4 4 4 4 4 4 4 4 4 4 4 4 4 4 4 4 0 1 1 1 1 1 1 1 1 1 1 1 1 1 1 1 1 1 1 1 0 4 4 4 4 4 42 37 37 37 37
37 37 43 0 4 4 4 4 14 15 16 17 4 4 4 4 4 4 4 4 39 37 37 37 37 43 4 4 4 4 4 4 4 4 44 40 40 40 37 37 37 37 43 4 4 4 4 4 4 4 4 4 4 4 4 4 4 4 4 4 4 4 4 4 4 4 4 4 0 1 1 1 1 1 1 1 1 1 3 1 3 1 1 1 1 1 1 1 0 4 4 4 4 4 42 37 37 37 37
37 37 43 0 0 4 4 4 18 19 20 21 4 4 4 4 4 4 4 4 42 37 37 37 37 37 41 4 4 4 4 4 4 4 4 44 37 37 37 37 37 37 37 41 4 4 4 4 4 4 4 4 4 4 4 4 4 4 4 4 4 4 4 4 4 4 4 4 4 0 1 1 1 1 1 1 1 1 1 3 1 3 3 3 3 1 1 1 1 0 4 4 4 4 4 42 37 37 37 37
37 37 43 0 4 4 4 4 4 4 4 4 4 4 4 4 4 4 4 4 44 37 37 37 37 37 46 4 4 4 4 4 4 4 4 4 44 45 37 37 0 0 37 43 4 4 4 4 4 4 0 4 4 4 4 4 4 4 4 4 4 4 4 4 4 4 4 4 4 0 1 1 1 3 3 3 3 3 1 3 1 1 1 1 3 1 1 1 1 0 4 4 4 4 4 42 37 37 37 37
37 37 43 0 4 4 4 4 1 1 1 1 1 4 4 4 4 4 4 4 4 44 45 45 45 46 4 4 4 4 4 4 4 4 4 4 4 4 44 45 45 45 45 46 4 4 4 4 4 4 0 4 4 4 4 4 4 4 4 4 4 4 4 4 4 4 4 4 4 0 1 3 1 3 1 1 1 3 1 3 1 1 1 1 3 1 1 1 1 0 4 4 4 4 4 42 37 37 37 37
37 37 43 0 4 4 4 4 1 3 3 3 1 4 4 4 4 4 4 4 0 0 0 5 0 0 0 4 4 4 4 4 4 0 5 5 5 5 5 5 5 0 0 4 4 4 4 4 4 4 0 4 4 4 4 4 4 4 4 4 4 4 4 4 4 4 4 4 4 0 1 3 1 3 1 1 1 3 3 3 3 3 3 3 3 3 3 1 1 0 4 4 4 4 4 42 37 37 37 37
37 45 46 0 4 4 4 4 1 3 3 3 1 4 4 4 4 4 4 4 4 0 0 0 0 0 4 4 4 4 4 4 4 4 5 5 5 5 5 5 5 5 4 4 4 4 4 4 4 4 0 0 0 0 0 0 0 0 0 0 0 0 0 0 0 0 0 0 0 0 1 3 1 3 1 1 1 3 3 1 1 1 1 1 1 3 3 1 1 0 4 4 4 4 4 42 37 37 37 37
37 43 0 0 4 4 4 4 1 3 3 3 1 4 4 4 4 4 4 4 4 4 0 0 0 4 4 4 4 4 4 4 4 4 5 5 5 5 5 5 5 5 4 4 4 4 4 4 5 5 5 5 5 5 5 5 5 5 5 5 5 5 5 5 5 5 5 5 5 5 3 3 3 3 1 1 1 1 3 3 3 3 1 1 1 3 3 3 1 0 4 4 4 4 4 42 37 37 37 37
37 43 0 4 4 4 4 4 1 3 3 3 1 4 4 4 4 4 4 4 4 4 0 5 0 4 4 4 4 4 4 4 4 4 5 5 5 5 5 5 5 5 4 4 4 4 4 4 5 5 0 0 0 0 0 0 0 0 0 0 0 0 0 0 0 0 0 0 0 0 3 3 1 1 1 1 1 1 1 1 1 3 1 3 1 1 1 3 1 0 4 4 4 4 4 42 37 37 37 37
37 43 0 4 4 4 4 4 1 1 5 1 1 4 4 4 4 4 4 4 4 4 0 5 0 4 4 4 4 4 4 4 4 4 5 5 5 5 5 5 5 5 4 4 4 4 4 4 5 5 0 4 4 4 4 4 4 4 4 4 4 4 4 4 4 4 4 4 4 0 1 1 1 1 3 3 3 3 3 1 1 3 1 1 3 1 1 3 1 0 4 4 4 4 4 42 37 37 37 37
37 43 0 4 4 4 4 4 4 0 5 0 4 4 4 4 4 4 4 4 4 4 0 5 0 4 4 4 4 4 4 4 4 4 4 5 5 5 5 5 5 4 4 4 4 4 4 4 5 5 0 4 4 4 4 4 4 4 4 4 4 4 4 4 4 4 4 4 4 0 1 1 1 1 3 1 1 3 3 1 3 3 1 1 1 1 1 3 1 0 4 4 4 4 4 42 37 37 37 37
37 47 0 4 4 4 4 4 4 0 5 0 4 4 4 4 4 4 4 4 4 4 0 5 0 4 4 4 6 7 8 9 4 4 4 4 4 4 5 4 4 4 4 4 4 4 4 4 5 5 0 4 4 4 4 4 4 4 4 4 4 4 4 4 4 4 4 4 4 0 1 1 1 1 3 1 1 1 1 1 3 1 1 1 1 1 3 3 1 0 4 4 4 4 4 42 37 37 37 37
37 43 0 4 4 4 4 4 4 0 5 0 4 4 4 4 4 4 4 4 4 4 0 5 0 4 4 4 10 11 12 13 4 4 4 4 4 4 5 5 5 4 4 4 4 4 0 0 5 5 0 4 4 4 4 4 4 4 4 4 4 4 4 4 4 4 4 4 4 0 1 1 1 1 3 3 3 3 3 3 3 1 1 1 1 1 3 3 1 0 4 4 4 4 4 0 0 42 38 37 37 37
37 43 0 4 4 4 4 0 0 0 5 0 4 4 4 4 4 4 4 4 4 4 0 5 0 4 4 4 14 15 16 17 4 4 4 4 4 4 4 4 5 4 4 4 4 4 0 0 5 5 0 4 4 4 4 4 4 4 4 4 4 4 4 4 4 4 4 4 4 0 1 1 3 1 3 3 3 1 1 1 1 1 3 3 1 1 3 1 1 0 4 4 4 4 4 0 0 42 37 37 37 37
37 43 0 4 4 4 4 0 5 5 5 0 4 4 4 4 4 4 4 4 4 4 0 5 0 4 4 4 18 19 20 21 4 4 4 4 4 4 5 5 5 4 4 4 4 4 0 0 5 5 0 4 2 4 4 4 4 4 4 4 4 4 4 4 4 4 4 4 4 0 1 1 1 1 1 1 1 1 1 1 1 1 3 1 1 3 3 1 1 0 4 4 4 4 4 39 40 37 37 37 37 37
37 43 0 4 4 4 4 0 5 0 0 0 4 4 4 4 4 4 4 4 4 4 0 5 0 4 4 4 4 4 0 5 0 4 4 4 4 4 5 4 4 4 4 4 4 4 4 4 5 5 0 4 4 4 4 4 4 4 4 4 4 4 4 4 4 4 4 4 4 0 1 1 3 1 3 3 3 1 1 3 3 3 3 3 3 3 1 3 1 0 4 4 4 4 4 42 37 37 37 37 37
37 43 0 4 4 4 4 0 5 0 4 4 4 4 4 4 4 4 4 4 4 4 0 5 0 4 4 4 4 4 0 5 0 4 4 4 5 5 5 4 4 4 4 4 4 4 4 4 5 5 0 4 4 4 4 4 4 4 4 4 4 4 4 4 4 4 4 4 4 0 1 1 3 1 1 1 1 1 1 3 1 1 1 1 3 1 1 3 1 0 4 4 4 4 4 42 37 37 37 37
37 43 0 4 4 4 4 0 5 0 4 4 4 4 4 4 4 4 4 4 4 0 0 5 0 0 4 4 4 4 0 5 0 4 4 4 5 4 4 4 4 4 4 4 4 4 4 4 5 5 0 4 4 4 4 4 4 4 4 4 4 4 4 4 4 4 4 4 4 0 1 1 1 1 1 1 1 1 1 1 1 1 1 1 3 1 1 1 1 0 4 4 4 4 4 42 37 37 37 37
37 43 0 4 4 4 4 0 5 0 0 0 0 0 0 0 0 0 0 0 0 0 0 5 0 0 0 0 0 0 0 5 0 0 0 0 0 0 0 0 0 0 0 0 0 0 0 0 5 5 0 4 4 4 4 4 4 4 4 4 4 4 4 4 4 4 4 4 4 0 0 0 0 0 0 0 0 0 0 0 0 0 0 0 5 0 0 0 0 0 4 4 4 4 4 42 37 37 37 37
37 37 41 0 0 0 4 0 5 5 5 5 5 5 5 5 5 5 5 5 5 5 5 5 5 5 5 5 5 5 5 5 5 5 5 5 5 5 5 5 5 5 5 5 5 5 5 5 5 5 0 4 4 4 4 4 4 4 4 4 4 4 4 4 4 4 4 4 4 4 4 4 4 4 4 4 4 4 4 4 5 4 4 0 5 0 0 0 0 4 4 4 4 4 39 37 37 37 37 37
37 37 43 0 0 4 4 0 0 5 0 4 0 0 0 0 0 0 4 0 0 0 0 5 0 0 0 0 0 0 0 0 0 0 0 0 0 0 0 0 0 0 0 0 0 0 0 0 5 5 0 4 4 4 4 4 4 4 4 4 4 4 4 4 4 4 4 4 4 4 4 4 4 4 4 4 4 4 4 4 5 4 4 0 5 5 5 5 0 4 4 4 4 4 42 37 37 37 37 37
37 37 43 0 4 4 4 0 5 0 4 0 0 0 0 0 0 4 4 4 4 0 5 0 0 0 4 4 4 4 4 4 4 4 4 4 4 4 4 4 4 4 4 4 4 0 0 5 5 5 5 5 5 5 5 5 5 5 5 5 5 5 5 5 5 5 5 5 5 5 5 5 5 5 5 5 5 5 5 5 5 4 0 0 0 0 5 0 4 4 4 4 4 4 42 37 37 37 37 37
37 37 43 0 4 4 4 4 0 5 0 4 0 0 0 0 0 0 4 4 4 4 0 5 0 4 4 4 4 4 4 4 4 4 4 4 4 4 4 4 4 4 4 4 4 4 0 0 5 5 0 4 4 4 4 4 4 4 4 4 4 4 4 4 4 4 4 4 5 4 4 4 4 4 4 4 4 4 4 4 5 4 4 4 4 4 0 5 0 4 4 4 4 4 42 37 37 37 37 37 37
37 37 46 0 4 4 4 4 0 5 0 4 0 0 0 0 0 0 4 4 4 4 0 5 0 4 4 4 4 4 4 4 4 4 4 4 4 4 4 4 4 4 4 4 4 4 0 0 5 5 0 4 4 4 4 4 4 4 4 4 4 4 4 4 4 4 4 4 4 5 5 4 4 4 4 4 4 4 4 4 5 5 4 4 4 4 0 5 0 4 4 4 4 4 44 37 37 37 37 37
37 43 0 0 4 4 4 4 0 5 0 4 4 4 0 4 4 4 4 4 4 4 0 5 0 0 4 4 4 4 4 4 4 4 4 4 4 4 4 4 4 4 4 4 4 4 0 0 5 5 0 4 4 4 4 4 4 4 4 4 4 4 4 4 4 4 4 5 5 5 5 5 4 4 4 4 4 4 4 4 4 5 4 4 4 4 0 5 0 4 4 4 4 4 0 42 37 37 37 37
37 43 4 4 4 4 4 4 0 5 0 4 4 4 0 4 4 4 4 4 4 4 0 5 0 0 0 0 4 4 4 4 4 4 4 0 4 4 4 4 4 4 4 4 4 4 0 0 5 5 0 4 4 4 4 4 4 4 4 4 4 4 4 4 4 5 5 5 5 5 5 5 5 5 4 4 4 4 4 4 4 5 4 4 4 4 0 5 0 4 4 4 4 4 4 42 37 37 37 37
37 43 4 4 4 4 4 4 0 5 0 4 4 4 0 4 4 4 4 4 0 0 0 5 0 0 0 0 0 4 0 4 4 4 4 4 4 4 4 4 4 4 4 4 4 4 0 0 5 5 0 0 0 0 4 4 4 4 4 4 4 4 4 4 4 4 5 5 5 5 5 5 5 4 4 4 4 4 4 4 4 5 4 4 4 4 0 5 0 4 4 4 4 4 4 44 37 37 37 37 37
37 43 4 4 4 4 4 4 0 5 0 4 4 4 4 4 4 4 4 4 0 6 7 8 9 5 0 0 0 4 4 4 4 4 4 4 4 4 4 4 4 4 4 4 0 35 0 0 0 0 35 0 0 0 4 4 4 4 4 4 4 4 4 4 4 4 5 5 5 5 5 4 4 4 4 4 4 4 4 4 5 4 4 4 4 0 5 0 4 4 4 4 4 4 4 4 42 37 37 37 37
37 43 4 4 4 4 4 4 0 5 0 4 4 4 4 4 4 4 4 4 0 10 11 12 13 5 0 4 4 4 4 4 4 4 4 4 4 4 4 4 4 4 0 0 0 36 0 0 0 0 36 0 0 0 4 4 4 4 4 4 4 4 4 4 4 5 5 5 4 4 4 4 4 4 4 4 4 4 5 4 4 4 4 0 5 0 4 4 4 4 4 4 4 4 4 4 42 37 37 37 37 37 37
37 43 4 4 4 4 4 4 0 5 0 4 4 4 4 4 4 4 4 4 0 14 15 16 17 5 0 0 0 0 4 4 4 4 4 4 4 4 4 4 0 0 0 0 0 36 30 30 30 30 36 0 0 0 0 4 4 4 4 4 4 4 4 4 4 4 4 4 4 4 4 4 4 4 4 4 5 4 4 4 4 0 5 0 4 4 4 4 4 4 4 4 4 4 4 0 44 37 37 37 37
37 43 4 4 4 4 4 4 0 5 0 4 4 4 4 4 4 4 4 4 0 18 19 20 21 5 0 0 0 0 0 0 0 0 0 0 0 0 0 0 0 0 0 0 29 36 27 27 27 27 36 31 0 0 0 0 0 0 0 0 0 0 0 0 0 0 0 0 0 0 0 0 0 0 0 5 0 0 0 0 0 5 0 4 4 4 4 4 4 4 4 4 4 4 4 4 4 42 37 37 37 37
37 43 4 4 4 4 4 4 0 5 0 0 0 0 0 0 0 0 0 0 0 0 0 5 0 0 0 0 0 0 0 0 0 0 0 0 0 0 0 0 0 0 0 0 26 36 33 33 33 33 36 28 5 5 5 5 5 5 5 5 5 5 5 5 5 5 5 5 5 5 5 5 5 5 5 5 5 5 5 5 5 5 5 5 0 4 4 4 4 4 4 4 4 4 4 4 4 42 37 37 37 37
37 43 4 4 4 4 4 4 0 5 5 5 5 5 5 5 5 5 5 5 5 5 5 5 5 5 5 5 5 5 5 5 5 5 5 5 5 5 5 5 5 5 5 5 32 36 36 22 23 36 36 34 0 0 0 0 0 0 0 0 0 0 0 0 0 0 0 0 0 0 0 0 5 0 0 0 0 5 0 0 0 0 0 0 0 0 0 5 0 4 4 4 4 4 4 4 4 42 37 37 37 37
37 43 4 4 0 4 4 4 4 4 4 4 4 4 4 4 4 5 4 4 4 5 5 5 0 0 0 0 0 0 0 0 0 0 0 0 0 0 0 0 0 0 0 0 36 36 36 24 25 36 36 36 0 0 4 4 4 4 4 4 4 4 4 4 4 4 4 4 4 4 4 0 5 0 4 4 4 5 4 4 4 4 4 4 4 4 0 5 0 4 4 4 4 4 4 4 4 42 37 37 37 37
37 43 4 4 4 0 0 0 0 0 0 0 0 0 4 4 4 5 4 4 4 5 5 5 0 0 0 4 4 4 4 4 4 4 4 4 4 4 4 4 4 4 4 0 36 36 36 24 25 36 36 36 0 0 4 4 4 4 4 4 4 4 4 4 4 4 4 4 4 4 4 0 5 0 4 4 4 5 4 4 4 4 4 4 4 4 0 5 0 4 4 4 4 4 4 4 4 42 37 37 37 37
37 43 4 4 4 0 6 7 8 9 0 0 0 0 4 4 4 5 4 0 0 0 0 5 0 0 0 4 4 4 4 4 4 4 0 0 0 0 0 4 4 4 4 0 0 0 0 0 0 0 5 0 0 0 0 0 0 0 0 4 4 4 4 4 4 4 4 4 4 4 4 0 5 0 4 4 4 4 4 4 4 5 4 4 4 4 0 5 0 4 4 4 4 4 4 39 37 37 37 37
37 43 4 4 4 0 10 11 12 13 0 0 4 4 4 5 4 4 0 0 0 0 0 5 0 0 0 0 4 4 0 4 4 0 0 0 0 0 0 4 4 4 4 4 4 4 4 4 4 4 5 4 4 4 4 4 4 4 4 4 4 4 4 4 4 4 4 4 4 4 4 0 5 0 4 4 4 4 4 4 4 5 4 4 4 4 0 5 0 4 4 4 4 4 4 42 37 37 37 37
37 43 4 4 4 0 14 15 16 17 0 0 4 4 4 5 4 4 0 0 0 0 0 5 0 0 0 0 4 4 4 4 0 0 0 0 0 0 0 4 4 4 4 4 4 4 4 4 4 4 5 4 4 4 4 4 4 4 4 4 4 4 4 4 4 4 4 4 4 4 4 0 5 0 4 4 4 4 4 4 4 5 0 0 0 0 0 5 0 4 4 4 4 4 4 42 37 37 37 37
37 43 4 4 4 0 18 19 20 21 0 0 4 0 4 5 4 4 0 0 0 0 0 5 0 0 0 0 0 4 4 4 0 0 0 0 0 4 0 4 4 4 4 4 4 4 4 4 4 4 5 4 4 4 4 4 4 4 4 4 4 4 4 4 4 4 4 4 4 4 4 0 5 0 4 4 4 4 4 4 5 5 0 39 40 40 40 40 40 41 4 4 4 4 4 42 37 37 37 37
37 43 4 4 4 0 0 5 0 0 0 0 0 0 4 4 4 5 5 5 5 5 5 5 0 0 0 0 0 0 0 0 0 0 4 0 0 0 0 4 4 4 4 4 4 4 4 4 4 4 5 4 4 4 4 4 4 4 4 4 4 4 6 7 8 9 4 4 4 4 4 0 5 0 4 4 4 4 4 4 5 5 0 42 37 37 37 37 37 43 4 4 4 4 4 42 37 37 37 37 37
37 43 4 4 4 4 4 5 5 5 5 5 5 5 5 5 5 5 4 0 0 0 0 5 0 0 0 4 4 4 4 0 0 0 0 0 0 0 0 4 4 4 4 4 4 4 4 4 4 4 5 4 4 4 4 4 4 4 4 4 4 4 10 11 12 13 4 4 4 0 0 0 5 0 0 0 4 5 5 5 4 0 0 42 37 37 37 37 37 43 4 4 4 4 4 42 37 37 37 37
37 43 4 4 4 4 4 4 4 4 4 4 4 4 4 4 4 4 4 4 0 0 0 5 0 0 4 4 4 4 4 0 0 4 0 0 4 0 0 4 4 4 4 4 4 4 4 4 4 4 5 4 4 4 4 4 4 4 4 4 4 4 14 15 16 17 4 4 4 0 0 0 5 0 0 4 4 4 5 5 5 5 5 42 37 37 37 37 37 43 4 4 4 4 4 42 37 37 37 37
37 43 4 4 4 4 4 4 4 4 4 4 4 4 4 4 4 4 4 4 0 6 7 8 9 0 0 0 0 4 4 4 0 0 0 0 0 0 4 4 4 4 4 4 4 4 4 4 4 4 5 5 5 5 5 5 5 5 5 5 5 5 18 19 20 21 4 4 4 0 0 0 5 0 0 0 4 4 4 4 5 0 0 42 37 37 37 37 37 43 4 4 4 4 4 42 37 37 37 37
37 43 4 4 4 4 4 4 4 4 4 4 4 4 4 4 4 4 4 4 0 10 11 12 13 0 0 4 4 4 4 4 4 4 4 4 4 4 4 4 4 4 4 4 4 4 4 4 4 4 5 4 2 4 4 4 4 4 4 5 5 5 5 5 5 4 4 4 4 0 0 0 5 0 0 0 4 4 4 4 5 0 0 42 37 37 37 37 37 43 4 4 4 4 4 42 37 38 37 37 37 37
37 43 4 4 4 4 4 4 4 4 4 4 4 4 4 4 4 4 4 4 0 14 15 16 17 5 5 5 5 5 5 5 5 5 5 5 5 5 5 5 5 5 5 5 5 5 5 5 5 5 5 4 2 4 4 4 4 4 5 5 5 4 4 4 4 4 4 4 0 0 0 0 5 0 0 4 4 4 4 0 5 0 0 42 37 37 37 37 37 43 4 4 4 4 4 42 37 37 37 37 37 37
37 43 4 4 4 4 4 4 4 4 4 4 4 4 4 4 4 4 4 4 0 18 19 20 21 0 0 4 4 4 4 4 4 4 4 4 4 4 4 4 4 4 4 4 4 4 4 4 4 4 4 4 4 4 4 4 4 4 5 5 5 4 4 4 4 4 4 4 0 0 0 0 5 0 0 4 4 4 4 0 5 0 0 42 37 37 37 37 37 43 4 4 4 4 4 42 37 37 37 37 37 37
37 43 4 4 4 4 4 4 4 4 4 4 4 0 0 4 4 4 0 0 0 0 0 5 5 5 0 0 4 4 4 4 4 4 4 4 4 4 4 4 4 4 4 4 4 4 4 4 4 4 4 4 4 4 4 4 4 4 4 4 5 4 4 4 4 4 0 0 0 0 0 0 5 5 5 5 5 5 5 5 5 0 0 44 45 45 45 45 45 46 4 4 4 4 4 42 37 37 37 37 37
37 43 4 4 4 4 4 4 4 0 0 0 4 4 4 0 0 0 0 4 0 4 5 5 5 5 4 4 4 4 4 4 4 4 4 4 4 4 4 4 4 4 4 4 4 4 4 4 4 0 0 5 5 5 5 5 5 5 5 5 5 4 4 4 4 4 0 0 0 0 0 0 5 0 0 0 0 0 0 0 5 0 0 0 0 0 0 0 0 0 0 0 0 0 0 42 37 37 37 37 37
37 43 4 4 4 4 4 4 0 4 4 0 0 0 0 0 0 0 0 0 0 0 0 5 5 0 4 4 4 4 4 4 4 0 0 0 0 0 0 4 4 4 4 4 4 4 4 4 4 0 0 5 0 0 0 0 0 0 0 0 5 4 4 4 4 4 0 0 0 0 0 5 0 0 0 0 0 0 0 5 0 0 0 0 0 0 0 0 0 0 0 0 0 0 0 42 37 37 37 37 37
37 43 4 4 4 4 4 4 0 4 0 0 0 0 0 0 0 0 0 0 0 0 0 5 5 0 0 0 0 0 0 0 0 0 0 0 0 0 0 0 0 0 0 0 0 0 0 0 0 0 0 5 0 0 4 4 4 4 4 4 5 4 4 4 4 4 0 0 0 0 0 6 7 8 9 0 0 0 0 0 5 0 0 0 6 7 8 9 4 4 4 4 4 4 4 42 37 37 37 37 37 37
37 43 4 4 4 4 4 4 4 4 0 0 0 6 7 8 9 4 0 0 0 0 0 5 5 5 5 5 5 5 5 5 0 5 5 5 5 5 5 5 5 5 5 5 5 5 5 5 5 5 5 5 0 0 4 4 4 4 4 4 5 4 4 4 4 4 0 0 0 0 0 10 11 12 13 0 0 0 0 0 5 0 4 4 10 11 12 13 4 4 4 4 4 4 4 44 37 37 37 37 37 37 37
37 43 4 4 4 4 4 4 0 0 4 0 0 10 11 12 13 0 0 0 0 5 5 0 0 0 0 0 0 0 0 0 0 0 0 0 0 0 0 0 0 0 0 0 0 0 0 0 0 5 0 0 4 4 4 4 4 4 4 4 5 4 4 4 4 4 0 0 0 0 0 14 15 16 17 0 0 0 0 0 5 0 4 4 14 15 16 17 4 4 4 4 4 4 4 4 42 37 37 37 37 37 37
37 43 4 4 4 4 4 4 0 4 0 0 0 14 15 16 17 0 0 0 0 5 5 0 0 0 0 0 0 0 0 0 0 0 4 0 0 0 0 4 4 4 4 4 4 4 0 0 0 5 0 0 4 4 4 4 4 4 4 4 5 4 4 4 4 4 0 0 0 0 0 18 19 20 21 0 0 4 4 4 5 0 4 4 18 19 20 21 4 4 4 4 4 4 4 4 42 37 37 37 37 37 37
37 43 4 4 4 4 4 4 0 4 4 4 0 18 19 20 21 0 4 0 0 5 5 0 0 0 0 4 4 4 4 0 0 0 0 0 0 0 0 4 4 4 4 4 4 4 0 0 0 5 0 0 4 4 4 4 4 4 4 4 5 5 5 5 5 5 5 5 5 5 5 5 5 5 0 0 0 0 0 4 5 0 4 4 4 4 5 4 4 4 4 4 4 4 4 4 42 37 37 37 37 37
37 43 4 4 4 4 4 4 0 0 0 0 0 0 5 5 0 0 0 0 0 0 0 5 0 0 4 4 4 4 0 0 4 0 0 4 0 0 4 4 4 4 4 4 4 4 4 4 0 0 0 5 0 0 4 4 4 4 4 4 4 4 4 4 4 0 0 0 0 0 0 0 5 5 5 5 5 5 5 5 5 5 5 5 5 5 4 4 4 4 4 4 4 4 4 42 37 37 37 37 37
37 43 5 5 5 5 5 5 5 5 5 5 5 5 5 5 4 4 4 4 4 4 4 5 5 0 0 4 4 4 4 4 0 0 0 0 0 0 4 4 4 4 4 4 4 4 4 4 0 0 5 0 0 0 4 4 4 4 4 4 4 4 4 4 4 4 0 0 0 0 0 0 0 0 4 4 4 4 4 4 4 4 4 4 4 4 4 4 4 4 4 4 4 4 4 4 42 37 37 37 37 37
37 43 5 5 5 5 4 4 4 4 4 4 4 4 4 5 4 4 4 4 4 4 4 5 5 0 0 4 4 4 4 4 4 4 4 4 4 4 4 4 4 4 4 4 4 4 4 4 0 5 5 0 0 0 4 4 4 4 4 4 4 4 4 4 4 4 4 4 4 4 4 4 4 4 4 4 4 4 4 4 4 4 4 4 4 4 4 4 4 4 4 4 4 4 4 4 42 37 37 37 37 37
37 43 4 4 4 4 4 4 4 4 4 4 4 4 4 5 5 5 5 5 5 5 5 5 5 0 0 4 4 4 4 4 4 4 4 4 4 4 4 4 4 4 4 4 0 0 0 0 0 5 5 0 0 0 0 0 0 4 4 4 4 4 4 4 4 4 4 4 4 4 4 4 4 4 4 4 4 4 4 4 4 4 4 4 4 4 4 4 4 4 4 4 4 4 4 4 42 37 37 37 37 37
37 43 4 4 4 4 4 4 4 4 4 4 4 4 4 4 4 4 4 4 4 4 4 5 5 0 0 4 4 4 4 4 4 4 4 4 4 4 4 4 4 4 4 4 0 39 40 40 40 40 40 41 0 0 4 4 4 4 4 4 4 4 4 4 4 4 4 4 4 4 4 4 4 4 4 4 4 4 4 4 4 4 4 4 4 4 4 4 4 4 4 4 4 4 4 4 42 37 37 37 37 37
37 43 4 4 4 4 4 4 4 4 4 4 4 4 4 4 4 4 4 4 4 4 4 4 5 5 0 0 0 0 0 0 0 0 0 0 0 0 0 0 0 0 0 0 0 42 37 37 37 37 37 43 0 0 4 4 4 4 4 4 4 4 4 4 4 4 4 4 4 4 4 4 4 4 4 4 4 4 4 4 4 4 4 4 4 4 4 4 4 4 4 4 4 4 4 4 42 37 37 37 37 37
37 43 4 4 4 4 4 4 4 4 4 4 4 4 4 4 4 4 4 4 4 4 4 4 5 5 5 5 5 5 5 5 5 5 5 5 5 5 5 5 5 5 5 5 5 42 37 37 37 37 37 43 0 0 4 4 4 4 4 4 4 4 4 4 4 4 4 4 4 4 4 4 4 4 4 4 4 4 4 4 4 4 4 4 4 4 4 4 4 4 4 4 4 4 4 4 42 37 37 37 37 37
37 43 4 4 4 4 4 4 4 4 4 4 4 4 4 4 4 4 4 4 4 4 4 4 5 5 5 5 5 5 5 5 5 5 5 5 5 5 5 5 5 5 5 5 5 42 37 37 37 37 37 43 0 0 4 4 4 4 4 4 4 4 4 4 4 4 4 4 4 4 4 4 4 4 4 4 4 4 4 4 4 4 4 4 4 4 4 4 4 4 4 4 4 4 4 4 44 45 37 37 37 37 37
37 43 1 35 1 1 1 1 35 1 1 1 1 1 1 1 1 1 4 4 4 4 4 5 5 5 0 0 0 0 0 0 0 0 0 0 0 0 0 0 0 0 0 0 0 42 37 37 37 37 37 43 0 4 4 4 4 4 4 4 4 4 4 4 4 4 4 4 4 4 4 5 4 4 4 4 4 4 4 4 4 4 4 4 4 4 4 4 4 4 4 4 4 4 4 4 4 4 42 37 37 37 37 37 37 37
37 43 0 36 0 0 0 0 36 0 0 0 0 0 0 0 4 1 0 0 4 4 4 4 5 5 0 0 0 4 0 4 4 4 4 4 4 4 4 4 4 4 4 0 0 44 45 45 45 45 45 46 5 5 5 5 5 5 5 5 5 5 5 5 5 5 5 5 5 5 4 5 5 5 5 4 4 4 4 4 4 4 4 4 4 4 4 4 4 4 4 4 4 4 4 4 4 4 42 37 37 37 37
37 43 0 36 30 30 30 30 36 0 0 0 0 4 4 0 0 1 0 4 4 4 5 5 0 0 4 4 4 4 4 4 4 4 4 4 4 4 4 4 4 0 0 0 0 0 0 0 0 0 0 0 0 0 0 0 0 0 0 0 0 0 0 0 0 0 0 0 0 0 0 0 0 5 4 4 4 4 4 4 4 4 4 4 4 4 4 4 4 4 4 4 4 4 4 4 4 4 42 37 37 37 37
37 43 29 36 27 27 27 27 36 31 0 0 4 4 0 0 0 1 4 4 4 5 5 0 0 4 4 4 4 4 4 4 4 4 4 4 4 4 4 4 4 4 4 4 4 4 4 4 4 4 4 4 4 4 4 4 4 4 4 4 4 4 4 4 4 4 4 4 4 4 4 0 5 4 4 4 4 4 4 4 4 4 4 4 4 4 4 4 4 4 4 4 4 4 4 4 4 4 42 37 37 37 37
37 43 26 36 33 33 33 33 36 28 0 0 4 4 0 0 0 1 4 4 4 5 5 0 0 0 0 0 0 0 0 0 0 0 0 0 0 0 0 0 0 0 0 0 0 0 0 0 0 0 0 0 0 0 0 0 0 0 0 0 0 0 0 0 0 0 0 0 0 0 0 0 5 4 4 4 4 4 4 4 4 4 4 4 4 4 4 4 4 4 4 4 4 4 4 4 4 4 42 37 37 37 37
37 43 32 36 36 22 23 36 36 34 0 0 4 4 0 0 0 1 4 4 4 5 5 5 5 5 5 5 5 5 5 5 5 5 5 5 5 5 5 5 5 5 5 5 5 5 5 5 5 5 5 5 5 5 5 5 5 5 5 5 5 5 5 5 5 5 5 5 5 5 5 5 5 5 5 5 5 5 5 5 5 5 5 4 4 4 4 4 4 4 4 4 4 4 4 4 39 40 37 37 37 37 37
37 43 36 36 36 24 25 36 36 36 0 0 4 4 0 0 0 1 4 4 4 5 5 0 5 5 5 5 5 5 5 4 4 4 4 4 4 4 4 4 4 4 4 4 4 4 4 4 4 4 4 4 4 4 4 4 4 4 4 0 0 0 0 0 0 0 0 0 0 0 0 0 0 0 0 0 0 0 0 0 0 0 0 0 4 4 4 4 4 4 4 4 4 4 4 39 37 37 37 37
37 43 36 36 36 24 25 36 36 36 0 0 4 4 0 0 0 1 4 4 4 4 5 0 0 0 0 0 5 5 5 0 0 0 0 0 0 0 0 0 0 0 0 0 0 0 0 0 0 0 0 0 0 0 0 0 0 0 0 0 0 0 0 0 0 0 0 0 0 0 0 0 0 0 0 0 0 0 0 0 0 0 0 0 0 0 0 0 0 0 0 0 0 0 0 42 37 37 37 37
37 43 0 0 0 0 0 0 0 4 0 0 0 0 0 0 0 1 0 0 0 4 4 4 4 5 5 4 4 1 1 1 1 5 1 1 1 1 1 1 1 1 1 1 1 1 1 1 1 1 61 1 1 1 1 1 1 1 1 1 1 1 1 1 1 1 4 4 4 4 4 4 4 4 4 4 4 4 4 4 4 4 4 0 0 1 1 1 1 1 1 1 1 1 1 1 1 1 1 1
37 43 4 4 4 4 4 4 4 4 4 4 4 4 4 0 0 0 0 0 0 0 5 5 5 5 5 4 4 1 67 67 67 67 67 67 67 67 67 66 03 03 03 03 65 67 67 67 67 67 62 67 51 52 52 54 67 67 67 59 59 59 67 67 67 1 0 0 0 0 0 0 0 0 0 0 0 0 0 0 0 0 0 0 0 3 3 1 3 1 1 3 3 1 1 1 3 3 3 1
37 43 1 1 1 1 1 1 1 1 1 1 1 1 1 1 1 1 4 4 4 4 4 5 5 5 4 4 4 1 67 67 67 67 67 67 67 67 67 66 03 03 03 57 65 67 67 67 67 67 67 67 66 57 03 65 67 67 67 67 67 67 67 67 67 1 0 0 0 0 0 0 0 0 4 0 0 0 0 0 0 0 0 0 0 1 3 3 1 3 1 3 3 3 1 3 3 1 3 1
37 43 0 0 0 0 0 0 0 0 0 0 0 0 0 0 0 0 0 0 0 0 0 0 0 4 4 4 4 1 67 67 67 67 67 67 51 52 52 68 03 57 57 03 69 54 67 67 67 67 67 67 66 03 57 65 67 67 67 67 67 67 67 67 67 1 4 4 4 4 4 4 4 4 4 4 4 4 4 4 4 4 4 4 4 1 1 3 3 3 1 3 3 1 1 3 1 3 3 1
37 43 0 4 4 4 4 4 4 4 4 4 4 4 4 4 4 4 4 4 4 4 4 4 4 4 4 4 4 1 67 67 67 67 67 67 55 56 56 56 56 56 56 56 56 53 70 72 51 52 52 52 68 03 57 69 52 52 52 52 52 54 70 71 72 1 4 4 4 4 4 4 4 4 4 4 4 4 4 4 4 4 4 4 4 1 1 3 3 1 3 1 3 1 1 3 1 3 1 1
37 43 0 4 4 4 4 4 4 4 4 4 4 4 4 4 4 4 4 4 4 4 4 4 4 4 4 4 4 1 67 67 67 67 67 67 01 01 01 01 01 01 01 01 01 01 70 72 66 03 03 03 03 03 03 03 03 03 03 03 03 65 70 71 72 1 4 4 4 4 4 4 4 4 4 4 4 4 4 4 4 4 4 4 4 1 1 3 1 3 1 1 1 3 3 1 3 3 3 1
37 43 0 4 4 4 4 4 4 4 4 4 4 1 1 1 1 1 1 1 1 1 1 1 1 1 1 1 1 1 67 67 67 67 67 67 01 01 01 01 01 01 58 01 01 01 67 67 66 03 03 03 03 03 03 03 03 03 03 03 03 65 67 67 67 1 4 4 4 4 4 4 4 4 4 4 4 4 4 4 4 4 4 4 4 1 3 3 3 3 1 1 1 3 3 3 3 1 3 1
37 43 0 4 4 4 4 4 4 4 4 4 4 1 67 67 67 67 67 67 67 67 67 67 67 67 67 67 67 67 67 67 67 67 67 67 67 67 67 67 67 67 67 67 67 67 67 67 55 56 56 56 56 56 56 56 56 56 56 56 56 53 67 67 67 1 4 4 4 4 4 4 4 4 4 4 4 4 4 4 4 4 4 4 4 1 1 3 3 1 1 1 3 3 3 1 3 1 3 1
37 43 0 4 4 4 4 4 4 4 4 4 4 1 67 73 73 73 73 73 73 67 67 67 67 67 67 51 52 52 52 52 52 54 67 67 67 67 67 67 67 67 67 67 67 67 67 67 01 01 01 01 01 63 01 01 61 01 01 01 01 01 67 67 67 1 4 4 4 4 4 4 4 4 4 4 4 4 4 4 4 4 4 4 4 1 3 1 3 3 3 1 3 1 3 3 1 3 3 1
37 43 0 4 4 4 4 4 4 4 4 4 4 1 67 67 67 67 67 67 67 67 67 67 67 67 67 66 03 03 57 57 03 65 67 67 67 67 67 67 67 67 67 67 67 67 67 67 01 01 01 01 01 64 01 01 62 01 01 01 01 01 67 67 67 1 4 4 4 4 4 4 4 4 4 4 4 4 4 4 4 4 4 4 4 1 3 1 3 1 3 3 3 1 3 3 1 1 1 1
37 43 0 4 4 4 4 4 4 4 4 4 4 1 67 67 67 67 67 67 67 67 67 67 67 67 67 55 56 57 03 03 57 53 67 67 67 67 67 67 67 67 67 67 67 67 67 67 67 67 67 67 67 67 67 67 67 67 67 67 67 67 67 67 67 1 4 4 4 4 4 4 4 4 4 4 4 4 4 4 4 4 4 4 4 1 3 1 3 3 1 3 3 1 1 3 3 3 3 1
37 43 0 4 4 4 4 4 4 4 4 4 4 1 67 67 67 67 67 67 67 67 67 67 67 67 67 01 01 55 56 56 53 01 67 67 67 67 67 67 67 67 67 67 67 67 67 67 67 67 67 67 67 67 67 67 67 67 67 67 67 67 67 67 67 1 4 4 4 4 4 4 4 4 4 4 4 4 4 4 4 4 4 4 4 1 3 1 3 3 1 3 3 3 1 3 3 1 1 1
37 43 0 4 4 4 4 4 4 4 4 4 4 1 67 67 67 67 67 67 67 67 67 67 67 67 67 67 67 01 01 01 01 67 67 67 67 67 67 67 67 67 67 67 67 67 67 67 67 67 67 67 67 67 67 67 67 67 67 67 67 67 67 67 67 1 4 4 4 4 4 4 4 4 4 4 4 4 4 4 4 4 4 4 4 1 3 1 1 3 3 3 1 3 3 1 3 1 1 1
37 43 0 4 4 4 4 4 4 4 4 4 4 1 1 1 1 1 1 1 1 1 1 1 1 1 1 1 1 1 1 1 1 1 1 1 1 1 1 1 1 1 1 1 1 1 1 1 1 1 1 1 1 1 1 1 1 1 1 1 1 1 1 1 1 1 4 4 4 4 4 4 4 4 4 4 4 4 4 4 4 4 4 4 4 1 3 1 1 3 3 3 3 3 3 3 3 3 3 3
37 43 0 4 4 4 4 4 4 4 4 4 4 4 4 4 4 4 4 4 4 4 4 4 4 4 4 4 4 4 4 4 4 4 4 4 4 4 4 4 4 4 4 4 4 4 4 4 4 4 4 4 4 4 4 4 4 4 4 4 4 4 4 4 4 4 4 4 4 4 4 4 4 4 4 4 4 4 4 4 4 4 4 4 4 1 1 1 1 1 1 1 1 1 1 1 1 1 1 1
37 43 0 0 0 0 0 0 0 0 0 0 0 0 0 0 0 0 0 0 0 0 0 0 0 0 0 0 0 0 0 0 0 0 0 0 0 0 0 0 0 0 0 0 0 0 0 0 0 0 0 0 0 0 0 0 0 0 0 0 0 0 0 0 0 0 0 0 0 0 0 0 0 0 0 0 0 0 0 0 0 0 0 0 0 0 0 0 0 0 0 0 0 0 0 0 0 0 0 0 37
37 43 40 40 40 40 40 40 40 40 40 40 40 40 40 40 40 40 40 40 40 40 40 40 40 40 40 40 40 40 40 40 40 40 40 40 40 40 40 40 40 40 40 40 40 40 40 40 40 40 40 40 40 40 40 40 40 40 40 40 40 40 40 40 40 40 40 40 40 40 40 40 40 40 40 40 40 40 40 40 40 40 40 40 40 40 40 40 40 40 40 40 40 40 40 40 40 40 40 37
38 38 38 38 38 38 38 38 38 38 38 38 38 38 38 38 38 38 38 38 38 38 38 38 38 38 38 38 38 38 38 38 38 38 38 38 38 38 38 38 38 38 38 38 38 38 38 38 38 38 38 38 38 38 38 38 38 38 38 38 38 38 38 38 38 38 38 38 38 38 38 38 38 38 38 38 38 38 38 38 38 38 38 38 38 38 38 38 38 38 38 38 38 38 38 38 38 38 38 38
38 38 38 38 38 38 38 38 38 38 38 38 38 38 38 38 38 38 38 38 38 38 38 38 38 38 38 38 38 38 38 38 38 38 38 38 38 38 38 38 38 38 38 38 38 38 38 38 38 38 38 38 38 38 38 38 38 38 38 38 38 38 38 38 38 38 38 38 38 38 38 38 38 38 38 38 38 38 38 38 38 38 38 38 38 38 38 38 38 38 38 38 38 38 38 38 38 38 38 38
38 38 38 38 38 38 38 38 38 38 38 38 38 38 38 38 38 38 38 38 38 38 38 38 38 38 38 38 38 38 38 38 38 38 38 38 38 38 38 38 38 38 38 38 38 38 38 38 38 38 38 38 38 38 38 38 38 38 38 38 38 38 38 38 38 38 38 38 38 38 38 38 38 38 38 38 38 38 38 38 38 38 38 38 38 38 38 38 38 38 38 38 38 38 38 38 38 38 38 38
38 38 38 38 38 38 38 38 38 38 38 38 38 38 38 38 38 38 38 38 38 38 38 38 38 38 38 38 38 38 38 38 38 38 38 38 38 38 38 38 38 38 38 38 38 38 38 38 38 38 38 38 38 38 38 38 38 38 38 38 38 38 38 38 38 38 38 38 38 38 38 38 38 38 38 38 38 38 38 38 38 38 38 38 38 38 38 38 38 38 38 38 38 38 38 38 38 38 38 38
38 38 38 38 38 38 38 38 38 38 38 38 38 38 38 38 38 38 38 38 38 38 38 38 38 38 38 38 38 38 38 38 38 38 38 38 38 38 38 38 38 38 38 38 38 38 38 38 38 38 38 38 38 38 38 38 38 38 38 38 38 38 38 38 38 38 38 38 38 38 38 38 38 38 38 38 38 38 38 38 38 38 38 38 38 38 38 38 38 38 38 38 38 38 38 38 38 38 38 38
38 38 38 38 38 38 38 38 38 38 38 38 38 38 38 38 38 38 38 38 38 38 38 38 38 38 38 38 38 38 38 38 38 38 38 38 38 38 38 38 38 38 38 38 38 38 38 38 38 38 38 38 38 38 38 38 38 38 38 38 38 38 38 38 38 38 38 38 38 38 38 38 38 38 38 38 38 38 38 38 38 38 38 38 38 38 38 38 38 38 38 38 38 38 38 38 38 38 38 38

